Авокадо - фрукт с зеленой кожурой.
Библиотека - место, где хранятся книги.
Велосипед - двухколесное средство передвижения.
Гитара - струнный музыкальный инструмент.
Динозавр - вымершее животное древности.
Ежевика - ягода с колючками.
Ёлка - новогодняя елка.
Жираф - высокий млекопитающий.
Загадка - загадочный вопрос.
Инженер - специалист по технике.
Комета - светящийся объект на небе.
Лавровый - венок из лавровых листьев.
Магнитофон - устройство для воспроизведения музыки.
Носорог - крупное животное с рогом на носу.
Оранжевый - цвет в спектре радуги.
Парашют - средство для плавного спуска с высоты.
Ракета - устройство для полета в космос.
Снеговик - фигура из снега.
Треугольник - геометрическая фигура.
Укроп - зелень для приправы.
Фиалка - цветок с яркими лепестками.
Хамелеон - ящерица меняющая цвет.
Цилиндр - геометрическое тело.
Черепаха - медленная рептилия.
Шампунь - средство для мытья волос.
Щенок - маленькая собака.
Экзотика - необычные растения и животные.
Ювелир - мастер по изготовлению украшений.
Яблоко - плод с яркой кожурой.
Аметист - фиолетовый драгоценный камень.
Баран - домашнее животное с рогами.
Воздушный - касающийся воздуха.
Гондола - лодка в Венеции.
Доктор - врач, лечащий болезни.
Единорог - мифическое животное с рогом.
Жареный - приготовленный на огне.
Зонтик - предмет для защиты от дождя.
Иглу - дом из снега у эскимосов.
Карандаш - инструмент для рисования.
Лимонад - прохладительный напиток.
Магия - необъяснимая сила.
Небоскреб - высокое здание.
Огурец - овощ с сочной мякотью.
Пижама - одежда для сна.
Радуга - разноцветное явление на небе.
Скрипка - струнный музыкальный инструмент.
Танцор - исполнитель танцев.
Утюг - прибор для глажения.
Фараон - древний египетский правитель.
Холодильник - устройство для хранения продуктов.
Циркон - драгоценный камень.
Черника - ягода синего цвета.
Шоколад - сладкое из какао.
Эскалатор - подвижная лестница.
Якорь - металлическое крепление для судов.
Арбуз - сочный летний фрукт.
Бульдозер - строительная техника.
Вулкан - горячий источник лавы.
Граммофон - устройство для проигрывания музыки.
Дельфин - морское млекопитающее.
Евкалипт - дерево с ароматными листьями.
Жилище - место для проживания.
Замок - крепость или здание для защиты.
Инь-Янь - символ в традиционной китайской философии.
Камера - устройство для фотографии.
Летучая мышь - ночное млекопитающее.
Мельница - сооружение для молотьбы зерна.
Невесомость - отсутствие веса.
Очки - аксессуар для защиты глаз.
Пирамида - структура с треугольной формой.
Радиатор - устройство для отопления.
Сакура - японская вишня.
Термометр - прибор для измерения температуры.
Урожай - собранные сельскохозяйственные культуры.
Ферма - место для разведения животных.
Холм - небольшое возвышение в земной поверхности.
Цветок - растение с красивыми лепестками.
Чемпион - победитель соревнований.
Шахматы - настольная игра на клетчатой доске.
Экспедиция - путешествие с целью исследования.
Ягода - мелкое съедобное плодовое растение.
Альпинист - человек, занимающийся альпинизмом.
Бриллиант - блестящий драгоценный камень.
Виолончель - струнный музыкальный инструмент.
Галактика - обширная система звезд и планет.
Динамит - взрывчатое вещество.
Жакет - верхняя одежда.
Застава - место для контроля движения.
Иглу - традиционное жилище эскимосов.
Картина - произведение изобразительного искусства.
Лекция - устное изложение материала.
Модель - представление чего-либо в уменьшенном виде.
Ножницы - инструмент для резки.
Облако - масса водяных капель в атмосфере.
Павлин - птица с красочными хвостовыми перьями.
Растение - организм, способный к фотосинтезу.
Слон - крупное млекопитающее с хоботом.
Тренажер - устройство для физических упражнений.
Утопия - идеальное общество.
Фонтан - источник воды, бьющий вверх.